EVENT_CREATE_OBJECT	EVENT_CREATE_OBJECT	creat
EVENT_OPEN	EVENT_OPEN	open
EVENT_CLOSE	EVENT_CLOSE	close
EVENT_READ	EVENT_READ	read
EVENT_WRITE	EVENT_WRITE	write
EVENT_CLONE	EVENT_CLONE	clone
EVENT_FORK	EVENT_FORK	fork
EVENT_CONNECT	EVENT_CONNECT	connect
EVENT_ACCEPT	EVENT_ACCEPT	accept
EVENT_EXECUTE	EVENT_EXECUTE	exec
EVENT_RECVFROM	EVENT_RECVFROM	recv
EVENT_RECVMSG	EVENT_RECVMSG	recv
EVENT_SENDTO	EVENT_SENDTO	send
EVENT_SENDMSG	EVENT_SENDMSG	send
EVENT_LOADLIBRARY	EVENT_LOADLIBRARY	load
EVENT_UNLINK	EVENT_UNLINK	delete
EVENT_LINK	EVENT_LINK	creat
EVENT_RENAME	EVENT_RENAME	rename
EVENT_UPDATE	EVENT_UPDATE	update

EVENT_READ,EVENT_EXECUTE,EVENT_RECVFROM,EVENT_RECVMSG,EVENT_LOADLIBRARY
EVENT_CLONE,EVENT_FORK,EVENT_OPEN,EVENT_CLOSE,EVENT_CONNECT,EVENT_ACCEPT,EVENT_LINK,EVENT_UNLINK,EVENT_CREATE_OBJECT,EVENT_WRITE,EVENT_SENDTO,EVENT_SENDMSG